' ------------------------------------------------------------------------------
' Blank levels with correct dimensions, to copy/paste when making new templates
' ------------------------------------------------------------------------------
'
' Open version
'
'################################################################################
'#..............................................................................#
'#..............................................................................#
'#..............................................................................#
'#..............................................................................#
'#..............................................................................#
'#..............................................................................#
'#..............................................................................#
'#..............................................................................#
'#..............................................................................#
'#..............................................................................#
'#..............................................................................#
'#..............................................................................#
'#..............................................................................#
'#..............................................................................#
'#..............................................................................#
'#..............................................................................#
'#..............................................................................#
'#..............................................................................#
'#..............................................................................#
'#..............................................................................#
'################################################################################

'
' Filled version
'
'################################################################################
'################################################################################
'################################################################################
'################################################################################
'################################################################################
'################################################################################
'################################################################################
'################################################################################
'################################################################################
'################################################################################
'################################################################################
'################################################################################
'################################################################################
'################################################################################
'################################################################################
'################################################################################
'################################################################################
'################################################################################
'################################################################################
'################################################################################
'################################################################################
'################################################################################


' ------------------------------------------------------------------------------
$ Intro forest
' ------------------------------------------------------------------------------
'
' Symbols used:
'
'   @   Start position, stone path
'   =   Stone path
'   _   Withered grass
'   .   Stone floor with some random grass/shrubs
'   #   Stone wall with some low/high rubble
'   &   Graves, or random grass and bushes
'   ,   Random grass and bushes
'   ~   Shallow water
'   t   Tree
'   v   Brazier
'   [   Church bench
'   -   Altar
'   *   Carpet
'   >   Stairs
'   +   Doors

tttttttttttttttttttttttttttttttttttttttttttttttttttttttttttttttttttttttttttttttt
tttttttttttttttttt,,,,,,,,,,tttttttt~~~~~~~~tttttttttt,,,tt,t,,t,,ttt,,ttttttttt
tttt,=,,,,ttttttt,,,,,t,,,,tttt~,~,~~~,,,~~~~,,~~ttttttt,,,,,,________,,,ttttttt
ttt,,,@,,,,,tttttt,,,,,,,,,,,,,,~,~~~,,t,,~,~~,,,,,,,,,,,,,,___________,,,,,,ttt
ttt,,,,=,,,,,tttttttt,,,,,,,,,,,,~~,~~,,,~~,~,,,,,,,,,,,,,_____######____,,ttttt
tt,,,,,,=,,,,tttttttttttt,,,,,,,,,~,~~,~~~,~,,,,,______________#....#_____,,,,tt
tt,,,,,,,=,t,tt,ttt,tttt,,,,,,,,,,,,,,,,,,,,,,,,_____________###....###____,,,tt
tttt,t,,,,=,,,,,,,,,t,,,,,,,,,,,,,,,,,,,,,,,,,,,__#####_#__#_#.#....#.#______,,t
tttttttt,,,========,,,,t,t,,,,,,,,,,,,,,,,,,t,,,__#...########.#....#.######_,tt
ttttttttt,,,,,,,,,,===,,tt,,,,,,,,,,,,,,,t,,,,,,__#...#...................##_,,t
ttttt,,ttttt,tt,tt,,,,=,,tt,,,,,,,,,tt,,,,,,&,&___#.#.#..[.[.[.[...[.[....>#_,tt
tt,,,,,,,,tttttttttt,,,=,,t,,tttt,,t,,,,,,,=======+...+*****************-..#_,tt
tttt,,,,,,,,,t,,,tttt,,&=,,,,,,ttt,ttt,,,,=,t,,___#.#.#..[.[.[.[...[.[.....#_,,t
ttttt,,,,,t,,,,,,,,,,,,,,=&,,,ttttttt,,,,=&,t,,,__#...#...................##_,tt
ttttt,,,,,,,t,,t,,,,,t,,,,=&,,,,tttttt,&=,,t,t,,__#...########.#....#.######_,tt
tttttt,,,t,,,,,,,,,,,,t,,,,=,t,ttt,tt,,=,,,tt,,,__#####_#__#_#,#....#.#_____,,,t
tttttt,,,,,,,,,tttt,,,,,,,,,===========,,,,ttt,,_____________###....###____,,ttt
tttttt,,,t,,,tttttt,,,,ttt,ttt,,t,t,,ttt,,,,t,,,,______________#....#_____,,,ttt
ttttttt,,,,,,,ttt,,,,,,,,tttt,,,,tt,t,,,,,,,,,,,,,,,,,,,,______######____,,,tttt
ttttttt,ttt,tttt,,,,,,,,,,,tttt,,,,tt,,,,tt,,t,,,,,,,,,,,,,,___________,,,t,,,tt
ttttttttttttttttt,,,t,,,ttttttttt,,,,,,,,,ttttt,,,,ttt,,t,,,,,,,,,,,,,,,tttttttt
tttttttttttttttttttttttttttttttttttttttttttttttttttttttttttttttttttttttttttttttt


' ------------------------------------------------------------------------------
$ Egypt
' ------------------------------------------------------------------------------
'
' Symbols used:
'
'   @   Start position, floor
'   .   Floor
'   #   Wall
'   v   Brazier
'   |   Pillar
'   S   Statue
'   P   Khephren, floor
'   M   Mummy, floor
'   C   Crocodile head mummy, floor
'   1   Stair candidate one, floor
'   2   Stair candidate two, floor

################################################################################
###...################################........................##################
###.1.###############################..######################..#################
###...##############################..#########################.################
####.##############################..####v....################|....|############
####.#############################..####..###v..##############......############
####.##########################.....####..######.v############|....|############
#####.####.#.#.#.#.###########..######v..#######..###############.##############
######.##|C........|#########.#######..##########..############..###############
#######.#...........##.....##.#####...############v.##########..################
########....M...C....#.#.#.#..####..###...#########..########..#################
#########..P.....C.#..........####.####.@...........v#######..##################
########....M...C....#.#.#.#..##|..|###...#################.v###################
#######.#...........##.....##.##....######################...###################
######.##|C........|#########.##|..|########......#######.v##.##################
#####.####.#.#.#.#.##########.####.########..###v..#####..####.#################
####.########################.####...#####..#####v..###..######.################
####.########################..#####..###..#######v.....########.###############
###...########################...####.....#############.#########.###|...|######
###.2.##########################...##################v..##########........######
###...############################v....................##############|...|######
################################################################################


' ------------------------------------------------------------------------------
$ Leng
' ------------------------------------------------------------------------------
'
' Symbols used:
'
'   @   Start position, floor
'   S   Leng Spider, grass
'   -   Grass
'   %   Wall (cliff)
'   #   Wall
'   .   Floor
'   E   Leng Elder, floor
'   $   Altar
'   +   Door

%%%%%%%%%%%%%%%%%%%%%%%%%%%%%%%%%%%%%%%%%%%%%%##################################
%%%%%%%%%%-%%--%--%%--%%%--%%--%%-%-%%%--%-%%-#.....#.....#.....#..............#
%@----%--------%---%---%--------%----%-----%--#.....#.....#.....#..............#
%%--------------------------------------------###.#####.#####.###..............#
%-------------%--------------------------%----#.................#..............#
%%------------%-------------------------------#...###.#####.###................#
%%---------------------%%%--------------%-----#...#.....#.....##################
%%%----%%---------------S%--------------------#...#.....#.....##################
%%%------------------%%-S%S------%------------#...################............##
%%%%-----------------%--%%-%----%%------------#......#...#......##.....$......##
%%%--------------------%%S--------------------##.###.#...#......###.$.....$...##
%%------------------%-%%S---------------------+......#...######.............E.##
%%%-------------------S%%S-%------------------##.###.#...#......###.$.....$...##
%%-------------------%-S%%-%----%-------------#...#..###.#.#######.....$......##
%%---------------------S%%S-------------------#...#......#......##............##
%%%------------------%-%%---------------%-----#.###############.#####.##########
%%-----%---------------------------%----------#.#.....###.............##########
%%%---------%---------------------------------#.#.###.###.####.######.##########
%%--%-----------------------------------------#.#.###.###.##....##....#....#####
%%%--------------%----------------%---%-----%-#.#.###.###.##...............#####
%%%%%%--%---%--%%%-%--%%%%%%%-%-%%%--%%--%-%%%#...###.....##....##....#....#####
%%%%%%%%%%%%%%%%%%%%%%%%%%%%%%%%%%%%%%%%%%%%%%##################################


' ------------------------------------------------------------------------------
$ Rat cave
' ------------------------------------------------------------------------------
'
' Symbols used:
'
'   @   Start position, floor
'   .   Floor
'   #   Cave wall
'   x   Constructed wall
'   &   Bones
'   1   Discovery event, floor
'   ,   Floor with random bones
'   r   Rat, floor with random bones
'   >   Stairs
'   |   Monolith
'   :   Stalagmite

################################################################################
##@#################,##,##xxxxxxxxx###xxxxxxxxxxx######rr#,##########,#,########
##.##############,,,,,,,,,x,,,,,,,xrrrxrr,rrr,rrxr,rrrr,,,,,,##,,#,,,,,,,#######
##...&##########,,,,xxxxxxx,,,,,,,xr,rxr,,,,,,,rxrrr,,,,,:,,,,,,,,,,,:,,,,######
###..:#########,,:,,x,,,,,,,,,,,,,,,,rrrrxx,xxrrxr,r,,,,,,,,,,,,,,,,,,,,,,,,,###
###:...#######,,,,,,xx,xxxx,,,,,,,xrrrxrrx,,,xrrxrrr,,,,,,,,:,,,,,,:,,,,,,######
##&..:..#####,,,,,,,,,,,,,xxxx,xxxx,r,xxxx,,,x,xx,,,,,,,,,,,,,,,,,,,,,,,,,######
####.&.:####,,,,,,,,,,,,,,,:,,,,,,,,,,,,,,,,,,,,,,,,,,,,,,,,,,,,,,,,,,:,,,,,####
####..##&:1.,,,,,,,,,:,,,,,,,,,,:,,,,,,,,,,,|,,,:,,,xxx,xx,xxx,,,,,,,,,,,,,#####
#####..&:.#,,,,,,,,,,,,,,,x,x,x,x,x,x,,,,|,,,,,|,,,rx,,,,,,,,x,,,,:,,,,,,,######
###########,,,,,,,,,,,,,,,,,,,,,,,,,,,,,,,,,,,,,,,,,x,rrrrr,,x,,,,,,,,,,,#######
###########,,,,,,,,|,,,,,,,,,,,,,,,,:,,,|,,,,,,,|,,rr,,,,,r,,,,,,,#,,,,,########
###########,,,,,|,,,,,|,,,,,,,,,,,,,,,,,,,,,,,,,,,,,x,r,rr,,,x,,####,,,,,#######
###########,,,,,,,,,,,,,,,x,x,x,x,x,x,,,,|,,,,,|,,,rx,,rrr,,,x,,,,##############
############,,,|,,,,,,,|,,,,,,,,,,,,,,,,,,,,|,,,,,x,x,r,,r,,,x,,,###############
############,,,,,,,,,,,,,,,,,,,,:,,,,,,,,,,,,,,,,,rr,,,rr,,,,x,:##xxxxxx########
#############,,,|,,,,,|,,,xxx,xxxxx,xxx,,,:,,,,r,,,rx,rr,,,,,x,,,,x....x########
##############,,,,,|,,,,,,x,,,,,xrrrrrx,,,,,,,,,,,r,x,r,,,,,rx,,,,...>.x########
#################,,,,,,:,,x,,,,,xrr,,rxrr,rr,rr,r,,,xxxxxxxxxx,:,,x....x########
################:,,,,,,,,,x,,,,,xrrrrrxrrrr##rrr,r,,rr,rr,rr,r,##:xxxxxx########
###################:,,####xxxxxxxxxxxxx##r#####rr###r###r#rrr###################
################################################################################


' ------------------------------------------------------------------------------
$ Boss level
' ------------------------------------------------------------------------------
'
' Symbols used:
'
'   @   Start position, floor
'   .   Floor
'   #   Wall
'   M   The High Priest, floor
'   |   Pillar
'   v   Brazier
'   >   Stairs

################################################################################
############################...................................................#
############################...................................................#
############################...#.....#...#.....#...#.....#...#.....#...........#
############################...###.###...###.###...###.###...###.###...........#
##############....#########......###.......###.......###.......###.............#
##############....#########....###.###...###.###...###.###...###.###...........#
############.#....#.#######....#.....#...#.....#...#.....#...#.....#...........#
#...########.#....#.#######.................................................####
#...#...................#.#.......|....|....|....|....|....|....#...#...#...####
#.#.#.............................................................v...v...v..###
#@..............................................................#.....M......###
#.#.#.............................................................v...v...v..###
#...#...................#.#.......|....|....|....|....|....|....#...#...#...####
#...########.#....#.#######.................................................####
############.#....#.#######....#.....#...#.....#...#.....#...#.....#...........#
##############....#########....###.###...###.###...###.###...###.###...........#
##############....#########......###.......###.......###.......###.............#
############################...###.###...###.###...###.###...###.###...........#
############################...#.....#...#.....#...##...##...#.....#...........#
############################...................................................#
################################################################################


' ------------------------------------------------------------------------------
$ Trapezohedron level
' ------------------------------------------------------------------------------
'
' Symbols used:
'
'   @   Start position, floor
'   .   Floor
'   #   Wall
'   |   Pillar
'   v   Brazier
'   o   Trapezohedron, floor

################################################################################
#####################################...|...####################################
#####################################.|...|.####################################
#####################################...|...####################################
####################################..|...|..###################################
###################################.....|.....##################################
##################################....|...|....#################################
#################################...#.......#...################################
#######.......................##..#.#.##.##.#.#..##.......######################
#######.|.|.|.|.|.|.|.|.|.|.|.#v..|.v.|...|.v.|..v#.|.|.|.######################
#######..@..............................o.................######################
#######.|.|.|.|.|.|.|.|.|.|.|.#v..|.v.|...|.v.|..v#.|.|.|.######################
#######.......................##..#.#.##.##.#.#..##.......######################
#################################...#.......#...################################
##################################....|...|....#################################
###################################.....|.....##################################
####################################..|...|..###################################
#####################################...|...####################################
#####################################.|...|.####################################
#####################################...|...####################################
################################################################################
################################################################################
