' ------------------------------------------------------------------------------
' Blank levels with correct dimensions, to copy/paste when making new templates
' ------------------------------------------------------------------------------
'
' Open version
'
'################################################################################
'#..............................................................................#
'#..............................................................................#
'#..............................................................................#
'#..............................................................................#
'#..............................................................................#
'#..............................................................................#
'#..............................................................................#
'#..............................................................................#
'#..............................................................................#
'#..............................................................................#
'#..............................................................................#
'#..............................................................................#
'#..............................................................................#
'#..............................................................................#
'#..............................................................................#
'#..............................................................................#
'#..............................................................................#
'#..............................................................................#
'#..............................................................................#
'#..............................................................................#
'################################################################################

'
' Filled version
'
'################################################################################
'################################################################################
'################################################################################
'################################################################################
'################################################################################
'################################################################################
'################################################################################
'################################################################################
'################################################################################
'################################################################################
'################################################################################
'################################################################################
'################################################################################
'################################################################################
'################################################################################
'################################################################################
'################################################################################
'################################################################################
'################################################################################
'################################################################################
'################################################################################
'################################################################################


' ------------------------------------------------------------------------------
$ Intro forest
' ------------------------------------------------------------------------------
'
' Symbols used:
'
'   @   Start position, stone path
'   =   Stone path
'   _   Withered grass
'   .   Stone floor with some random grass/shrubs
'   #   Stone wall with some low/high rubble
'   &   Graves, or random grass and bushes
'   ,   Random grass and bushes
'   ~   Shallow water
'   t   Tree
'   v   Brazier
'   [   Church bench
'   -   Altar
'   *   Carpet
'   >   Stairs
'   +   Doors

tttttttttttttttttttttttttttttttttttttttttttttttttttttttttttttttttttttttttttttttt
tttttttttttttttttt,,,,,,,,,,tttttttt~~~~~~~~tttttttttt,,,tt,t,,t,,ttt,,ttttttttt
ttttttttttttttttt,,,,,t,,,,tttt~,~,~~~,,,~~~~,,~~ttttttt,,,,,,________,,,ttttttt
tttttttttttttttttt,,,,,,,,,,,,,,~,~~~,,t,,~,~~,,,,,,,,,,,,,,___________,,,,,,ttt
ttttttt=,t,tttttttttt,,,,,,,,,,,,~~,~~,,,~~,~,,,,,,,,,,,,,_____######____,,ttttt
tttttt,,=,,,ttttt,t,ttttt,,,,,,,,,~,~~,~~~,~,,,,,______________#....#_____,,,,tt
tttttt,t,=,,t,,,,,,,,ttt,,,,,,,,,,,,,,,,,,,,,,,,_____________###....###____,,,tt
ttttttt,,t=,,,,,,,,t,,,,,,,,,,,,,,,,,,,,,,,,,,,,__#####_#__#_#.#....#.#______,,t
tttttttt,,,==@=====,,,,t,t,,,,,,,,,,,,,,,,,,t,,,__#...########.#....#.######_,tt
ttttttttttt,,,,,,,,===,,tt,,,,,,,,,,,,,,,t,,,,,,__#...#...................##_,,t
tttttttttttttt,,t,,,,,=,,tt,,,,,,,,,tt,,,,,,&,&___#.#.#..[.[.[.[...[.[....>#_,tt
ttttttttttttttttttt,,,,=,,t,,tttt,,t,,,,,,,=======+...+*****************-..#_,tt
ttttttttttttttttttttt,,&=,,,,,,ttt,ttt,,,,=,t,,___#.#.#..[.[.[.[...[.[.....#_,,t
ttttttttttttttt,,,,,,,,,,=&,,,ttttttt,,,,=&,t,,,__#...#...................##_,tt
tttttttttttttt,,,,t,,t,,,,=&,,,,ttttt,,&=,,t,t,,__#...########.#....#.######_,tt
ttttttttttttttt,,,,,,,t,,,,=,t,t,t,t,,,=,,,tt,,,__#####_#__#_#,#....#.#_____,,,t
tttttttttttttttt,tt,,,,,,,,,===========,,,,ttt,,_____________###....###____,,ttt
ttttttttttttttttttt,,,,ttt,ttt,,,,,,,t,t,,,,t,,,,______________#....#_____,,,ttt
ttttttttttttttttt,,,,,,,,tttt,,,,tt,t,,,,,,,,,,,,,,,,,,,,______######____,,,tttt
tttttttttttttttt,,,,,,,,,,,tttt,,,,tt,,,,tt,,t,,,,,,,,,,,,,,___________,,,t,,,tt
ttttttttttttttttt,,,t,,,ttttttttt,,,,,,,,,ttttt,,,,ttt,,t,,,,,,,,,,,,,,,tttttttt
tttttttttttttttttttttttttttttttttttttttttttttttttttttttttttttttttttttttttttttttt


' ------------------------------------------------------------------------------
$ Egypt
' ------------------------------------------------------------------------------
'
' Symbols used:
'
'   @   Start position, floor
'   .   Floor
'   #   Wall
'   ~   Water
'   +   Door
'   v   Brazier
'   S   Statue
'   P   Khephren, floor
'   M   Mummy, floor
'   C   Crocodile head mummy, floor
'   1   Stair candidate one, floor
'   2   -
'   3   -
'   4   -

################################################################################
###...##...###########################........................##################
###.1.##.3.##########################..######################..#################
###...##...#########################..#########################.################
####.####.#########################..####v....###############~.....~############
####.####.########################..####..###v..#############~.....~############
####.####+#####################.....####..######.v###########~.....~############
####...##~~#.#.#.#.#..C#######..######v..#######..###############.##############
######.##~~~.C.......########.#######..##########..############..###############
######.##~~~........##.....##.#####...############v.##########..################
######..+~~~M........#.#.#.#..####..###...~~~~~~~##..########..#################
#########~~~P....C.#..........####.####.@...........v#######..##################
######..+~~~M........#.#.#.#..##....###...~~~~~~~##########.v###################
######.##~~~........##.....##.##....######################...###################
######.##~~~.C.......########.##....########......#######.v##.##################
####...##~~#.#.#.#.#..C######.####.########..###v..#####..####.#################
####.####+###################.####...#####..#####v..###..######.################
####.####.###################..#####..###..#######v.....########.###############
###...##...###################...####.....#############.#########.###.....######
###.2.##.4.#####################...##################v..##########........######
###...##...#######################v....................##############.....######
################################################################################


' ------------------------------------------------------------------------------
$ Leng
' ------------------------------------------------------------------------------
'
' Symbols used:
'
'   @   Start position, floor
'   S   Leng Spider, grass
'   -   Grass
'   %   Wall (cliff)
'   #   Wall
'   .   Floor
'   E   Leng Elder, floor
'   $   Altar
'   +   Door

%%%%%%%%%%%%%%%%%%%%%%%%%%%%%%%%%%%%%%%%%%%%%%##################################
%%%%%%%%%%-%%--%--%%--%%%--%%--%%-%-%%%--%-%%-#.....#.....#.....#..............#
%@----%--------%---%---%--------%----%-----%--#.....#.....#.....#..............#
%%--------------------------------------------###.#####.#####.###..............#
%-------------%--------------------------%----#.................#..............#
%%------------%-------------------------------#...###.#####.###................#
%%---------------------%%%--------------%-----#...#.....#.....##################
%%%----%%---------------S%--------------------#...#.....#.....##################
%%%------------------%%-S%S------%------------#...################............##
%%%%-----------------%--%%-%----%%------------#......#...#......##.....$......##
%%%--------------------%%S--------------------##.###.#...#......###.$.....$...##
%%------------------%-%%S---------------------+......#...######.............E.##
%%%-------------------S%%S-%------------------##.###.#...#......###.$.....$...##
%%-------------------%-S%%-%----%-------------#...#..###.#.#######.....$......##
%%---------------------S%%S-------------------#...#......#......##............##
%%%------------------%-%%---------------%-----#.###############.#####.##########
%%-----%---------------------------%----------#.#.....###.............##########
%%%---------%---------------------------------#.#.###.###.####.######.##########
%%--%-----------------------------------------#.#.###.###.##....##....#....#####
%%%--------------%----------------%---%-----%-#.#.###.###.##...............#####
%%%%%%--%---%--%%%-%--%%%%%%%-%-%%%--%%--%-%%%#...###.....##....##....#....#####
%%%%%%%%%%%%%%%%%%%%%%%%%%%%%%%%%%%%%%%%%%%%%%##################################


' ------------------------------------------------------------------------------
$ Rat cave
' ------------------------------------------------------------------------------
'
' Symbols used:
'
'   @   Start position, floor
'   .   Floor
'   #   Cave wall
'   x   Constructed wall
'   &   Bones
'   1   Discovery event, floor
'   ,   Floor with random bones
'   r   Rat, floor with random bones
'   >   Stairs
'   |   Monolith
'   :   Stalagmite

################################################################################
##@#################,##,##xxxxxxxxx###xxxxxxxxxxx######rr#,##########,#,########
##.##############,,,,,,,,,x,,,,,,,xrrrxrr,rrr,rrxr,rrrr,,,,,,##,,#,,,,,,,#######
##...&##########,,,,xxxxxxx,,,,,,,xr,rxr,,,,,,,rxrrr,,,,,:,,,,,,,,,,,:,,,,######
###..:#########,,:,,x,,,,,,,,,,,,,,,,rrrrxx,xxrrxr,r,,,,,,,,,,,,,,,,,,,,,,,,,###
###:...#######,,,,,,xx,xxxx,,,,,,,xrrrxrrx,,,xrrxrrr,,,,,,,,:,,,,,,:,,|,,,######
##&..:..#####,,,,,,,,,,,,,xxxx,xxxx,r,xxxx,,,x,xx,,,,,,,,,,,,,,,,,,,,,,,,,######
####.&.:####,,,,,,,,,,,,,,,:,,,,,,,,,,,,,,,,,,,,,,,,,,,,,,,,,,,,,,,,,,:,,,,,####
####..##&:1.,,,,,,,,,:,,,,,,,,,,:,,,,,,,,,,,,,,,:,,,xxx,xx,xxx,,,,,,,,,,,,,#####
#####..&:.#,,,,,,,,,,,,,,,x,x,x,x,x,x,,,,,,|,,,,,,,rx,,,,,,,,x,,,,:,,,,,,,######
###########,,,,,,,,,,,,,,,,,,,,,,,,,,,,,,,,,,,,,,,,,x,rrrrr,,x,,,,,,,,,,,#######
###########,,,,,,,,,,,,,,,,,,,,,,,,,:,,,,,,,,,,,,,,rr,,,,,r,,,,,,,#,,,,,########
###########,,,,,,,,,,,,,,,,,,,,,,,,,,,,,,,,,,,,,,,,,x,r,rr,,,x,,####,,,,,#######
###########,,,,,,,,,,,,,,,x,x,x,x,x,x,,,,,,,,,,,,,,rx,,rrr,,,x,,,,##############
############,,,,,,,,,,,,,,,,,,,,,,,,,,,,,,,,,,,,,,x,x,r,,r,,,x,,,###############
############,,,,,,,,,,,,,,,,,,,,:,,,,,,,,,,,,,,,,,rr,,,rr,,,,x,:##xxxxxx########
#############,,,,,,,,,,,,,xxx,xxxxx,xxx,,,:,,,,r,,,rx,rr,,,,,x,,,,x....x########
##############,,,,,,,,,,,,x,,,,,xrrrrrx,,,,,,,,,,,r,x,r,,,,,rx,,,,...>.x########
#################,,,|,,:,,x,,,,,xrr,,rxrr,rr,rr,r,,,xxxxxxxxxx,:,,x....x########
################:,,,,,,,,,x,,,,,xrrrrrxrrrr##rrr,r,,rr,rr,rr,r,##:xxxxxx########
###################:,,####xxxxxxxxxxxxx##r#####rr###r###r#rrr###################
################################################################################


' ------------------------------------------------------------------------------
$ Boss level
' ------------------------------------------------------------------------------
'
' Symbols used:
'
'   @   Start position, floor
'   .   Floor
'   #   Wall
'   P  The High Priest, floor
'   W  "War Veteran" guard, floor
'   R  "Rogue" guard, floor
'   G  "Ghoul" guard, floor
'   v   Brazier
'   >   Stairs

################################################################################
###########################...................................................R#
###########################....................................................#
###########################....#.....#...#.....#...#.....#...#.....#...........#
###########################....###.###...###.###...###.###...###.###...........#
##############....#########......###.......###.......###.......###.............#
##############....#########....###.###...###.###...###.###...###.###...........#
############.#....#.#######....#.....#...#.....#...#.....#...#.....#...........#
#...########.#....#.#######.................................................####
#...#...................#.#.......#....#....#....#....#....#....#...#...#...####
#.#.#.............................................................v...v...v..###
#@............................................................W.#.....P......###
#.#.#.............................................................v...v...v..###
#...#...................#.#.......#....#....#....#....#....#....#...#...#...####
#...########.#....#.#######.................................................####
############.#....#.#######....#.....#...#.....#...#.....#...#.....#..G........#
##############....#########....###.###...###.###...###.###...###.###...........#
##############....#########......###.......###.......###.......###.............#
###########################....###.###...###.###...###.###...###.###...........#
###########################....#.....#...#.....#...##...##...#.....#...........#
###########################....................................................#
################################################################################


' ------------------------------------------------------------------------------
$ Trapezohedron level
' ------------------------------------------------------------------------------
'
' Symbols used:
'
'   @   Start position, floor
'   .   Floor
'   #   Wall
'   v   Brazier
'   o   Trapezohedron, floor

################################################################################
#####################################...#...####################################
#####################################.#...#.####################################
#####################################...#...####################################
####################################..#...#..###################################
###################################.....#.....##################################
##################################....#...#....#################################
#################################...#.......#...################################
#######.......................##..#.#.##.##.#.#..##.......######################
#######.#.#.#.#.#.#.#.#.#.#.#.#v..#.v.#...#.v.#..v#.#.#.#.######################
#######..@..............................o.................######################
#######.#.#.#.#.#.#.#.#.#.#.#.#v..#.v.#...#.v.#..v#.#.#.#.######################
#######.......................##..#.#.##.##.#.#..##.......######################
#################################...#.......#...################################
##################################....#...#....#################################
###################################.....#.....##################################
####################################..#...#..###################################
#####################################...#...####################################
#####################################.#...#.####################################
#####################################...#...####################################
################################################################################
################################################################################
